さくらぎまの	櫻木真乃	人名	
はちみやめぐる	八宮めぐる	人名	
かざのひおり	風野灯織	人名	
つきおかこがね	月岡恋鐘	人名	
たなかまみみ	田中摩美々	人名	
しらせさくや	白瀬咲耶	人名	
みつみねゆいか	三峰結華	人名	
ゆうこくきりこ	幽谷霧子	人名	
くわやまちゆき	桑山千雪	人名	
おおさきてんか	大崎甜花	人名	
おおさきあまな	大崎甘奈	人名	
こみやかほ	小宮果穂	人名	
さいじょうじゅり	西城樹里	人名	
ありすがわなつは	有栖川夏葉	人名	
もりのりんぜ	杜野凛世	人名	
そのだちよこ	園田智代子	人名	
まの	真乃	人名	
めぐる	めぐる	人名	
ひおり	灯織	人名	
こがね	恋鐘	人名	
まみみ	摩美々	人名	
さくや	咲耶	人名	
ゆいか	結華	人名	
きりこ	霧子	人名	
ちゆき	千雪	人名	
あまな	甘奈	人名	
かほ	果穂	人名	
じゅり	樹里	人名	
なつは	夏葉	人名	
りんぜ	凛世	人名	
ちよこ	智代子	人名	
いるみねーしょんすたーず	イルミネーションスターズ	固有名詞	
あんてぃーか	アンティーカ	固有名詞	
あるすとろめりあ	アルストロメリア	固有名詞	
ほうかごくらいまっくすがーるず	放課後クライマックスガールズ	固有名詞	
いるみね	イルミネ	固有名詞	
あんてぃーか	L'Antica	固有名詞	
ほうくら	放クラ	固有名詞	
あるすとろめりあ	ALSTROMERIA	固有名詞	
いるみねーしょんすたーず	illuminationSTARS	固有名詞	
がくしゃろんぶん	学者論文	名詞	
りゅういち	流1	名詞	
りゅうに	流2	名詞	
りゅうさん	流3	名詞	
とくいち	特1	名詞	
とくに	特2	名詞	
おで	オデ	名詞	
すぴあ	スピア	名詞	
なんばーわん	ﾅ˝ﾝ˝ﾊﾞｰ˝ﾜ˝ﾝ˝	名詞	
せりざわあさひ	芹沢あさひ	人名	
まゆずみふゆこ	黛冬優子	人名	
いずみめい	和泉愛依	人名	
ふゆこ	冬優子	人名	
めい	愛依	人名	
すとれいらいと	Straylight	固有名詞	
のくちる	noctchill	固有名詞	
あさくらとおる	浅倉透	人名	
ひぐちまどか	樋口円香	人名	
ふくまるこいと	福丸小糸	人名	
いちかわひなな	市川雛菜	人名	
ひなな	雛菜	人名	
うたひめしゅうかい	歌姫周回	固有名詞	
えきまの	駅真乃	固有名詞	
うぃんぐ	W.I.N.G.	固有名詞	
ぐらっど	G.R.A.D.	固有名詞	
